#############################
# $  #                     $#
#   ###   #### ####   #######
#     #    #$   #     # $   #
#     #    ### ##     ##   ##
##    #            $   #   ##
###   ####    ## ###        #
##     $#     #$   #  ###   #
#      ###    ###  #    #####
#   #####     #$#  #    #   #
#   ###    ##   #  #   ##  $#
#    #   #####  #       #   #
#  ###     ##   #  #        #
#    ##     #     ###     ###
#        $  #      #   #   ##
#                  $   #   ##
# $ ##     ##    ##### # # $#
#############################